211111111111111111112
100000000000000000001
100000000000000000001
100000001111100000001
100000000000000000001
100000000000000000001
100000000111000000001
100000000000000000001
100100000000000001001
100101000000000101001
100101000000000101001
100101000000000101001
100100000000000001001
100000000000000000001
100000000000000000001
100000000111000000001
100000000000000000001
100000001111100000001
100000000000000000001
100000000000000000001
211111111111111111112
